NAN = "countries/Territoire_non_revendiqu√©.txt"
LOU = "countries/Louisiane.txt"
GLD = "countries/Galicie_lodomerie.txt"
BUC = "countries/Bucovine.txt"
CRA = "countries/Cracovie.txt"
WAL = "countries/Valachie.txt"
FRC = "countries/Francfort.txt"
HAM = "countries/Hambourg.txt"
LUB = "countries/Lubeck.txt"
PLT = "countries/Palatinat.txt"
BAD = "countries/Bade.txt"
OLD = "countries/Oldenbourg.txt" 
AUG = "countries/Augsbourg.txt"
NUR = "countries/Nuremberg.txt"
DRT = "countries/Dortmund.txt"
KOL = "countries/Koln.txt"
KLN = "countries/Cologne.txt"
TRE = "countries/Treves.txt"
ULM = "countries/Ulm.txt"
PSS = "countries/Passau.txt"
MKZ = "countries/Strelitz.txt"
SCH = "countries/Schleswig.txt"
HLS = "countries/Holstein.txt"
POM = "countries/Pomeranie.txt"
MLO = "countries/Milan.txt"
VNS = "countries/Venise.txt"
LIG = "countries/Ligurie.txt"
EMI = "countries/Emilie.txt"
BRE = "countries/Breme.txt"
MRK = "countries/Marck.txt"
NSS = "countries/Nassau.txt"
DST = "countries/darmstadt.txt"
BRG = "countries/Berg.txt"
SXA = "countries/Saxe_anhalt.txt"
SXS = "countries/Saxe_Saalfeld.txt"
GOT = "countries/Gotha.txt"
WEI = "countries/Weimar.txt"
MAI = "countries/Mayence.txt"
BRW = "countries/Brunswick.txt"
CLE = "countries/Cleves.txt"
PDB = "countries/Paderborn.txt"
MUN = "countries/Ger_munster.txt"
SAY = "countries/Sayn.txt"
BYR = "countries/Bayreuth.txt"
BAM = "countries/Bamberg.txt"
SPI = "countries/Spire.txt"
TEX = "countries/Texas.txt"
FLO = "countries/Floride.txt"
CAL = "countries/Californie.txt"
ADY = "countries/Circassie.txt"
LAP = "countries/Laponie.txt"
COM = "countries/Comtat_venaissin"
PRO = "countries/Provence"
WLN = "countries/Wallonie"
ADR = "countries/Andorre"
ARA = "countries/Aragon"
TRG = "countries/Touaregs"
HEJ = "countries/Hedjaz"
HIL = "countries/Hail"
SML = "countries/Somaliland"
MAJ = "countries/Majeerteen"
MOG = "countries/Mogadiscio"
CHP = "countries/Champa"
RYU = "countries/Ryukyu"
HOK = "countries/Hokkaido"
LOS = "countries/Los_altos"
CEN = "countries/Centramerique"
KBA = "countries/Kuba"
UBA = "countries/Luba"
KZB = "countries/Kazembe"
YEK = "countries/Yeke"
BYN = "countries/Bunyoro"
BUG = "countries/Buganda"
OUA = "countries/Ouaddai"
ALK = "countries/Alaska"
RUS = "countries/Russie"
GRN = "countries/Greenland.txt"
RAP = "countries/Rapa Nui.txt"
YUC = "countries/Yucatan.txt"
RIG = "countries/Rio Grande.txt"
QUE = "countries/Quebec.txt"
KAT = "countries/Katanga.txt"
BIA = "countries/Biafra.txt"
WLA = "countries/Welsh Argentina.txt"
CBV = "countries/Cabo Verde.txt"
BAR = "countries/Barotseland.txt"
SOK = "countries/Sokoto.txt"
HES = "countries/Hesse.txt"
RHI = "countries/Rhineland.txt"
UBD = "countries/United Baltic Duchy.txt"
GAR = "countries/Guarani.txt"
INC = "countries/Inca.txt"
MIS = "countries/Miskito.txt"
MAY = "countries/Maya.txt"
INU = "countries/Inuit.txt"
CHR = "countries/Charrua.txt"
ITZ = "countries/Itza.txt"
NAH = "countries/Nahua.txt"
IAS = "countries/Isthmo Amerindia.txt"


C01 = "countries/Algerie-FR"
C02 = "countries/Afrique-Equatoriale-FR"
C03 = "countries/Afrique-Occidentale-FR"
C04 = "countries/Gambia-sierraleone-EN"
C05 = "countries/Nigeria-golden-EN"
C06 = "countries/Madagascar-EN"
C07 = "countries/East-africa-EN"
C08 = "countries/Rio-de-Oro-SP"
C09 = "countries/Philippines-SP"
C10 = "countries/Indochina-SP"
C11 = "countries/East-india-ND"
C12 = "countries/Angola-PT"
C13 = "countries/South-rhodesia-PT"
C14 = "countries/north-rhodesia-PT"
C15 = "countries/Mozambique-PT"

#Liste Futur#


